	NO ./textures/north_wall.png
			SO ./textures/south_wall.png
				WE ./textures/west_wall.png
					EA ./textures/east_wall.png
F 255,255,255
C 0,0,0

1111111111111111111111111111111
1000000000000000000000000000001
1011111111111111111111111111101
1010000000000000000000000000101
1010111111111111111111111111101
1010100000000000000000000001101
1000101111111111111111110101101
1010101000000000000000000101101
1010001011111111111111110101101
1010101010000000000000010101101
1010101010111111111101010101101
1010101010100000000001010101101
1010101010101111011101010101101
1010101010100000N00101010101101
1010101010101111011101000101101
1010101010100000000001010101101
1010101010111111111111010101101
1010101010000000000000010101101
1010101011111111111111110101101
1010101000000000000000000101101
1010101111111111111111111101101
1010100000000000000000000001101
1010111111111111111111111011101
1010000000000000000000000000101
1011111111111111111111111111101
1000000000000000000000000000001
1111111111111111111111111111111
