	NO ./textures/north_wall.png
	SO ./textures/south_wall.png


			WE 			./textures/west_wall.png
			EA 			./textures/east_wall.png


		F	 0,  0,  0
			C 				200, 0,  	0



111111111111111
100000100000001
101110101111101
101000000000101
101011111110101
100010000010001
111010111010111
100000101000001
101111101111101
10000E000000001
111111111111111
