NO ./src/textures/nature-theme/north_wall.png
SO ./src/textures/nature-theme/south_wall.png
WE ./src/textures/nature-theme/west_wall.png
EA ./src/textures/nature-theme/east_wall.png
F 85,107,47
C 135,206,250

1111111111111111111111111111111
1000000000000000000000000000001
1000111110000001111111111111001
1000100010000001000000000001001
1000100010000001000000000001001
1000111110000001000000000001001
1000000000000001000000000001001
1000000000000001000000000001001
1000000000000001000000000001001
1000000000000001000000000001001
1000111111111111000000000001001
1000100000N0000000000000000001
1000100000000000000000000000001
1000100000000000000000000000001
1000111111111111000000000001001
1000000000000001000000000001001
1000000000000001000000000001001
1000000000000001000000000001001
1000000000000001000000000001001
1000000000000001111111111111001
1111111111111111111111111111111