NO ./textures/north_wall.png
SO ./textures/south_wall.png
WE ./textures/west_wall.png
EA ./textures/east_wall.png
F 139,119,101
C 205,180,158

11111111111111111
10000001000000001
10101010101010101
10000001000000001
10110000100001101
10100000000000101
10000000W00000001
10100000000000101
10110000100001101
10000001000000001
10101010101010101
10000001000000001
11111111111111111