NO ./textures/north_wall.png
SO ./textures/south_wall.png
WE ./textures/west_wall.png
EA ./textures/east_wall.png

F 245,222,179
C 135,206,235

11111111111
10000000001
10111011101
10000000001
10101110101
1000S000001
10100110101
10000000001
10111011101
10000000001
11111111111
