NO ./north.xpm
SO ./south.xpm
WE ./west.xpm
EA ./east.xpm
F  220,100,0
C  0,0,0
11111
1N  1
111111
