NO ./north.xpm
SO ./south.xpm
WE ./west.xpm
EA ./east.xpm
F  220,100,0
C  0,0,0
11111111111111111111111111
1E000001111000000000001111
11111001  1001111111100011
1   1101  1010000000010011
111 1101111010111111010011
1     0  0  0  0   10  11
11111 011111111 11110  11
1   1 0     0   0  0  011
1 1 1 011111011111 111 11
1 1   0   0 0   0   0  11
1 111111 1010111111111 11
1     0    0 0      0 11
11111 01111111111111  11
1     0      0    0  11
11111111111111111111111111
