NO ./textures/north_wall.png
SO ./textures/south_wall.png
WE ./textures/west_wall.png
EA ./textures/east_wall.png
F 220,100,0
C 225,30,0

             11
            1111
        1111111111 1
    11111111111111 11111
    11000000000000000011
    110N0000000000000011
    11000111111111100011
    110001        100011
    110001  1111  100011
    110001        100011
    11000111111111100011
    11000000000000000011
    11000000000000000011
    11111111111111111111
        11111111111
            1111
             11
            