NO ./textures/north_wall.png
SO ./textures/south_wall.png
WE ./textures/west_wall.png
EA ./textures/east_wall.png
F 255,150,50		100,3,5
C 200,2,3
11111
1N0X1
10001
11111
