NO ./textures/north_wall.png
SO ./textures/south_wall.png
WE ./textures/west_wall.png
EA ./textures/east_wall.png
F 255,1a50,3
C 20b0,2,3
11111
1N0X1
10001
11111
