NO ./textures/north_wall.png
SO ./textures/south_wall.png
WE ./textures/west_wall.png
EA ./textures/east_wall.png
F 255,-150,-50
C 200,8,8
11111
1N0X1
10001
11111
