NO ./n.xpm
SO ./s.xpm
WE ./w.xpm
EA ./e.xpm
F  100,100,100
C  0,0,0
1111
1N01
1S11
1111
